{
  "schema": "toolbox.tilemap/1",
  "version": 1,
  "map": {
    "name": "tile-editor-sample-objective",
    "width": 20,
    "height": 12,
    "tileSize": 24
  },
  "tileset": [
    { "id": 0, "name": "Empty", "color": "transparent" },
    { "id": 1, "name": "Grass", "color": "#4a8f39" },
    { "id": 2, "name": "Dirt", "color": "#7a5230" },
    { "id": 3, "name": "Stone", "color": "#6b7280" },
    { "id": 5, "name": "Sand", "color": "#d4b46a" },
    { "id": 6, "name": "Road", "color": "#334155" }
  ],
  "layers": [
    {
      "id": "ground",
      "name": "Ground",
      "kind": "tile",
      "visible": true,
      "locked": false,
      "data": [
        [5,5,5,5,5,5,5,5,5,5,5,5,5,5,5,5,5,5,5,5],
        [5,5,5,5,5,5,5,5,5,5,5,5,5,5,5,5,5,5,5,5],
        [5,5,6,6,6,6,6,6,6,6,6,6,6,6,6,6,6,6,5,5],
        [5,5,6,1,1,1,1,1,1,1,1,1,1,1,1,1,1,6,5,5],
        [5,5,6,1,3,3,3,1,1,1,1,1,3,3,3,1,1,6,5,5],
        [5,5,6,1,3,1,3,1,1,1,1,1,3,1,3,1,1,6,5,5],
        [5,5,6,1,3,3,3,1,1,1,1,1,3,3,3,1,1,6,5,5],
        [5,5,6,1,1,1,1,1,1,1,1,1,1,1,1,1,1,6,5,5],
        [5,5,6,6,6,6,6,6,6,6,6,6,6,6,6,6,6,6,5,5],
        [5,5,5,5,5,5,5,5,5,5,5,5,5,5,5,5,5,5,5,5],
        [5,5,5,5,5,5,5,5,5,5,5,5,5,5,5,5,5,5,5,5],
        [5,5,5,5,5,5,5,5,5,5,5,5,5,5,5,5,5,5,5,5]
      ]
    },
    {
      "id": "collision",
      "name": "Collision",
      "kind": "collision",
      "visible": true,
      "locked": false,
      "data": [
        [0,0,0,0,0,0,0,0,0,0,0,0,0,0,0,0,0,0,0,0],
        [0,0,0,0,0,0,0,0,0,0,0,0,0,0,0,0,0,0,0,0],
        [0,0,1,1,1,1,1,1,1,1,1,1,1,1,1,1,1,1,0,0],
        [0,0,1,0,0,0,0,0,0,0,0,0,0,0,0,0,0,1,0,0],
        [0,0,1,0,1,1,1,0,0,0,0,0,1,1,1,0,0,1,0,0],
        [0,0,1,0,1,0,1,0,0,0,0,0,1,0,1,0,0,1,0,0],
        [0,0,1,0,1,1,1,0,0,0,0,0,1,1,1,0,0,1,0,0],
        [0,0,1,0,0,0,0,0,0,0,0,0,0,0,0,0,0,1,0,0],
        [0,0,1,1,1,1,1,1,1,1,1,1,1,1,1,1,1,1,0,0],
        [0,0,0,0,0,0,0,0,0,0,0,0,0,0,0,0,0,0,0,0],
        [0,0,0,0,0,0,0,0,0,0,0,0,0,0,0,0,0,0,0,0],
        [0,0,0,0,0,0,0,0,0,0,0,0,0,0,0,0,0,0,0,0]
      ]
    },
    {
      "id": "data",
      "name": "Data",
      "kind": "data",
      "visible": true,
      "locked": false,
      "data": [
        [0,0,0,0,0,0,0,0,0,0,0,0,0,0,0,0,0,0,0,0],
        [0,0,0,0,0,0,0,0,0,0,0,0,0,0,0,0,0,0,0,0],
        [0,0,0,0,0,0,0,0,0,0,0,0,0,0,0,0,0,0,0,0],
        [0,0,0,0,0,0,0,0,7,7,7,0,0,0,0,0,0,0,0,0],
        [0,0,0,0,0,0,0,0,7,9,7,0,0,0,0,0,0,0,0,0],
        [0,0,0,0,0,0,0,0,7,7,7,0,0,0,0,0,0,0,0,0],
        [0,0,0,0,0,0,0,0,0,0,0,0,0,0,0,0,0,0,0,0],
        [0,0,0,0,0,0,0,0,0,0,0,0,0,0,0,0,0,0,0,0],
        [0,0,0,0,0,0,0,0,0,0,0,0,0,0,0,0,0,0,0,0],
        [0,0,0,0,0,0,0,0,0,0,0,0,0,0,0,0,0,0,0,0],
        [0,0,0,0,0,0,0,0,0,0,0,0,0,0,0,0,0,0,0,0],
        [0,0,0,0,0,0,0,0,0,0,0,0,0,0,0,0,0,0,0,0]
      ]
    }
  ],
  "markers": [
    { "id": "spawn-a", "type": "spawn", "name": "entry", "col": 3, "row": 7, "properties": {} },
    { "id": "spawn-b", "type": "spawn", "name": "boss-room", "col": 16, "row": 3, "properties": {} },
    { "id": "object-key", "type": "object", "name": "gold-key", "col": 9, "row": 4, "properties": { "objective": "collect" } },
    { "id": "object-gate", "type": "object", "name": "exit-gate", "col": 16, "row": 7, "properties": { "requires": "gold-key" } }
  ],
  "parallax": {
    "schema": "toolbox.parallax/1",
    "companionEditor": "ParallaxEditor",
    "layers": []
  },
  "metadata": {
    "createdAt": "2026-03-30T00:00:00.000Z",
    "updatedAt": "2026-03-30T00:00:00.000Z",
    "notes": "Tile Editor sample with data/object emphasis"
  }
}
